"filename", "language", "TypeScript", "TypeScript JSX", "CSS", "Markdown", "comment", "blank", "total"
"/Users/tolokoban/Code/OBI/core-web-app/src/components/LandingPage/LandingPage.module.css", "CSS", 0, 0, 111, 0, 2, 18, 131
"/Users/tolokoban/Code/OBI/core-web-app/src/components/LandingPage/LandingPage.tsx", "TypeScript JSX", 0, 87, 0, 0, 0, 10, 97
"/Users/tolokoban/Code/OBI/core-web-app/src/components/LandingPage/Matomo.tsx", "TypeScript JSX", 0, 17, 0, 0, 0, 1, 18
"/Users/tolokoban/Code/OBI/core-web-app/src/components/LandingPage/README.md", "Markdown", 0, 0, 0, 3, 0, 2, 5
"/Users/tolokoban/Code/OBI/core-web-app/src/components/LandingPage/components/CenteredColumn/CenteredColumn.module.css", "CSS", 0, 0, 8, 0, 0, 2, 10
"/Users/tolokoban/Code/OBI/core-web-app/src/components/LandingPage/components/CenteredColumn/CenteredColumn.tsx", "TypeScript JSX", 0, 15, 0, 0, 0, 5, 20
"/Users/tolokoban/Code/OBI/core-web-app/src/components/LandingPage/components/CenteredColumn/index.ts", "TypeScript", 1, 0, 0, 0, 0, 1, 2
"/Users/tolokoban/Code/OBI/core-web-app/src/components/LandingPage/components/Error/Error.module.css", "CSS", 0, 0, 9, 0, 0, 1, 10
"/Users/tolokoban/Code/OBI/core-web-app/src/components/LandingPage/components/Error/Error.tsx", "TypeScript JSX", 0, 11, 0, 0, 0, 5, 16
"/Users/tolokoban/Code/OBI/core-web-app/src/components/LandingPage/components/Error/index.ts", "TypeScript", 1, 0, 0, 0, 0, 1, 2
"/Users/tolokoban/Code/OBI/core-web-app/src/components/LandingPage/components/PaddedBlock/PaddedBlock.module.css", "CSS", 0, 0, 17, 0, 0, 3, 20
"/Users/tolokoban/Code/OBI/core-web-app/src/components/LandingPage/components/PaddedBlock/PaddedBlock.tsx", "TypeScript JSX", 0, 10, 0, 0, 0, 4, 14
"/Users/tolokoban/Code/OBI/core-web-app/src/components/LandingPage/components/PaddedBlock/index.ts", "TypeScript", 1, 0, 0, 0, 0, 1, 2
"/Users/tolokoban/Code/OBI/core-web-app/src/components/LandingPage/components/ProgressiveImage/ProgressiveImage.module.css", "CSS", 0, 0, 17, 0, 0, 3, 20
"/Users/tolokoban/Code/OBI/core-web-app/src/components/LandingPage/components/ProgressiveImage/ProgressiveImage.tsx", "TypeScript JSX", 0, 39, 0, 0, 0, 6, 45
"/Users/tolokoban/Code/OBI/core-web-app/src/components/LandingPage/components/ProgressiveImage/index.ts", "TypeScript", 1, 0, 0, 0, 0, 1, 2
"/Users/tolokoban/Code/OBI/core-web-app/src/components/LandingPage/components/SanityContentRTF/SanityContentItems/SanityContentItems.module.css", "CSS", 0, 0, 16, 0, 0, 3, 19
"/Users/tolokoban/Code/OBI/core-web-app/src/components/LandingPage/components/SanityContentRTF/SanityContentItems/SanityContentItems.tsx", "TypeScript JSX", 0, 32, 0, 0, 1, 5, 38
"/Users/tolokoban/Code/OBI/core-web-app/src/components/LandingPage/components/SanityContentRTF/SanityContentItems/index.ts", "TypeScript", 1, 0, 0, 0, 0, 1, 2
"/Users/tolokoban/Code/OBI/core-web-app/src/components/LandingPage/components/SanityContentRTF/SanityContentParagraph/SanityContentParagraph.module.css", "CSS", 0, 0, 3, 0, 0, 1, 4
"/Users/tolokoban/Code/OBI/core-web-app/src/components/LandingPage/components/SanityContentRTF/SanityContentParagraph/SanityContentParagraph.tsx", "TypeScript JSX", 0, 16, 0, 0, 0, 5, 21
"/Users/tolokoban/Code/OBI/core-web-app/src/components/LandingPage/components/SanityContentRTF/SanityContentParagraph/index.ts", "TypeScript", 1, 0, 0, 0, 0, 1, 2
"/Users/tolokoban/Code/OBI/core-web-app/src/components/LandingPage/components/SanityContentRTF/SanityContentPreview/SanityContentPreview.module.css", "CSS", 0, 0, 66, 0, 0, 13, 79
"/Users/tolokoban/Code/OBI/core-web-app/src/components/LandingPage/components/SanityContentRTF/SanityContentPreview/SanityContentPreview.tsx", "TypeScript JSX", 0, 57, 0, 0, 0, 5, 62
"/Users/tolokoban/Code/OBI/core-web-app/src/components/LandingPage/components/SanityContentRTF/SanityContentPreview/index.ts", "TypeScript", 1, 0, 0, 0, 0, 1, 2
"/Users/tolokoban/Code/OBI/core-web-app/src/components/LandingPage/components/SanityContentRTF/SanityContentRTF.module.css", "CSS", 0, 0, 0, 0, 0, 1, 1
"/Users/tolokoban/Code/OBI/core-web-app/src/components/LandingPage/components/SanityContentRTF/SanityContentRTF.tsx", "TypeScript JSX", 0, 58, 0, 0, 0, 5, 63
"/Users/tolokoban/Code/OBI/core-web-app/src/components/LandingPage/components/SanityContentRTF/SanityContentTitle/SanityContentTitle.module.css", "CSS", 0, 0, 3, 0, 0, 1, 4
"/Users/tolokoban/Code/OBI/core-web-app/src/components/LandingPage/components/SanityContentRTF/SanityContentTitle/SanityContentTitle.tsx", "TypeScript JSX", 0, 15, 0, 0, 0, 5, 20
"/Users/tolokoban/Code/OBI/core-web-app/src/components/LandingPage/components/SanityContentRTF/SanityContentTitle/index.ts", "TypeScript", 1, 0, 0, 0, 0, 1, 2
"/Users/tolokoban/Code/OBI/core-web-app/src/components/LandingPage/components/SanityContentRTF/SanityContentVerticalSpace/SanityContentVerticalSpace.module.css", "CSS", 0, 0, 14, 0, 0, 4, 18
"/Users/tolokoban/Code/OBI/core-web-app/src/components/LandingPage/components/SanityContentRTF/SanityContentVerticalSpace/SanityContentVerticalSpace.tsx", "TypeScript JSX", 0, 19, 0, 0, 0, 5, 24
"/Users/tolokoban/Code/OBI/core-web-app/src/components/LandingPage/components/SanityContentRTF/SanityContentVerticalSpace/index.ts", "TypeScript", 1, 0, 0, 0, 0, 1, 2
"/Users/tolokoban/Code/OBI/core-web-app/src/components/LandingPage/components/SanityContentRTF/SanityContentWidget/SanityContentWidget.module.css", "CSS", 0, 0, 0, 0, 0, 1, 1
"/Users/tolokoban/Code/OBI/core-web-app/src/components/LandingPage/components/SanityContentRTF/SanityContentWidget/SanityContentWidget.tsx", "TypeScript JSX", 0, 53, 0, 0, 0, 4, 57
"/Users/tolokoban/Code/OBI/core-web-app/src/components/LandingPage/components/SanityContentRTF/SanityContentWidget/index.ts", "TypeScript", 1, 0, 0, 0, 0, 1, 2
"/Users/tolokoban/Code/OBI/core-web-app/src/components/LandingPage/components/SanityContentRTF/index.ts", "TypeScript", 1, 0, 0, 0, 0, 1, 2
"/Users/tolokoban/Code/OBI/core-web-app/src/components/LandingPage/components/Text/Text.module.css", "CSS", 0, 0, 7, 0, 0, 2, 9
"/Users/tolokoban/Code/OBI/core-web-app/src/components/LandingPage/components/Text/Text.tsx", "TypeScript JSX", 0, 18, 0, 0, 0, 5, 23
"/Users/tolokoban/Code/OBI/core-web-app/src/components/LandingPage/components/Text/index.ts", "TypeScript", 1, 0, 0, 0, 0, 1, 2
"/Users/tolokoban/Code/OBI/core-web-app/src/components/LandingPage/components/Title/Title.module.css", "CSS", 0, 0, 25, 0, 0, 5, 30
"/Users/tolokoban/Code/OBI/core-web-app/src/components/LandingPage/components/Title/Title.tsx", "TypeScript JSX", 0, 32, 0, 0, 0, 6, 38
"/Users/tolokoban/Code/OBI/core-web-app/src/components/LandingPage/components/Title/index.ts", "TypeScript", 1, 0, 0, 0, 0, 1, 2
"/Users/tolokoban/Code/OBI/core-web-app/src/components/LandingPage/components/VerticalRuler/VerticalRuler.module.css", "CSS", 0, 0, 15, 0, 0, 2, 17
"/Users/tolokoban/Code/OBI/core-web-app/src/components/LandingPage/components/VerticalRuler/VerticalRuler.tsx", "TypeScript JSX", 0, 27, 0, 0, 0, 5, 32
"/Users/tolokoban/Code/OBI/core-web-app/src/components/LandingPage/components/VerticalRuler/index.ts", "TypeScript", 1, 0, 0, 0, 0, 1, 2
"/Users/tolokoban/Code/OBI/core-web-app/src/components/LandingPage/components/VerticalSpace/VerticalSpace.module.css", "CSS", 0, 0, 2, 0, 0, 1, 3
"/Users/tolokoban/Code/OBI/core-web-app/src/components/LandingPage/components/VerticalSpace/VerticalSpace.tsx", "TypeScript JSX", 0, 10, 0, 0, 0, 5, 15
"/Users/tolokoban/Code/OBI/core-web-app/src/components/LandingPage/components/VerticalSpace/index.ts", "TypeScript", 1, 0, 0, 0, 0, 1, 2
"/Users/tolokoban/Code/OBI/core-web-app/src/components/LandingPage/components/Video/Video.module.css", "CSS", 0, 0, 11, 0, 0, 2, 13
"/Users/tolokoban/Code/OBI/core-web-app/src/components/LandingPage/components/Video/Video.tsx", "TypeScript JSX", 0, 14, 0, 0, 0, 5, 19
"/Users/tolokoban/Code/OBI/core-web-app/src/components/LandingPage/components/Video/index.ts", "TypeScript", 1, 0, 0, 0, 0, 1, 2
"/Users/tolokoban/Code/OBI/core-web-app/src/components/LandingPage/components/buttons/Button/Button.module.css", "CSS", 0, 0, 70, 0, 0, 10, 80
"/Users/tolokoban/Code/OBI/core-web-app/src/components/LandingPage/components/buttons/Button/Button.tsx", "TypeScript JSX", 0, 44, 0, 0, 1, 5, 50
"/Users/tolokoban/Code/OBI/core-web-app/src/components/LandingPage/components/buttons/Button/index.ts", "TypeScript", 1, 0, 0, 0, 0, 1, 2
"/Users/tolokoban/Code/OBI/core-web-app/src/components/LandingPage/components/buttons/EmailButton/EmailButton.module.css", "CSS", 0, 0, 22, 0, 0, 3, 25
"/Users/tolokoban/Code/OBI/core-web-app/src/components/LandingPage/components/buttons/EmailButton/EmailButton.tsx", "TypeScript JSX", 0, 20, 0, 0, 0, 5, 25
"/Users/tolokoban/Code/OBI/core-web-app/src/components/LandingPage/components/buttons/EmailButton/index.ts", "TypeScript", 1, 0, 0, 0, 0, 1, 2
"/Users/tolokoban/Code/OBI/core-web-app/src/components/LandingPage/components/buttons/LoginButton/LoginButton.tsx", "TypeScript JSX", 0, 17, 0, 0, 0, 5, 22
"/Users/tolokoban/Code/OBI/core-web-app/src/components/LandingPage/components/buttons/LoginButton/index.ts", "TypeScript", 1, 0, 0, 0, 0, 1, 2
"/Users/tolokoban/Code/OBI/core-web-app/src/components/LandingPage/constants.ts", "TypeScript", 38, 0, 0, 0, 0, 7, 45
"/Users/tolokoban/Code/OBI/core-web-app/src/components/LandingPage/content/_common.ts", "TypeScript", 18, 0, 0, 0, 4, 4, 26
"/Users/tolokoban/Code/OBI/core-web-app/src/components/LandingPage/content/about.ts", "TypeScript", 6, 0, 0, 0, 0, 2, 8
"/Users/tolokoban/Code/OBI/core-web-app/src/components/LandingPage/content/content.ts", "TypeScript", 76, 0, 0, 0, 9, 8, 93
"/Users/tolokoban/Code/OBI/core-web-app/src/components/LandingPage/content/contributors.ts", "TypeScript", 26, 0, 0, 0, 0, 5, 31
"/Users/tolokoban/Code/OBI/core-web-app/src/components/LandingPage/content/email.ts", "TypeScript", 22, 0, 0, 0, 0, 7, 29
"/Users/tolokoban/Code/OBI/core-web-app/src/components/LandingPage/content/hero.ts", "TypeScript", 66, 0, 0, 0, 0, 6, 72
"/Users/tolokoban/Code/OBI/core-web-app/src/components/LandingPage/content/home.ts", "TypeScript", 6, 0, 0, 0, 0, 2, 8
"/Users/tolokoban/Code/OBI/core-web-app/src/components/LandingPage/content/index.ts", "TypeScript", 12, 0, 0, 0, 0, 2, 14
"/Users/tolokoban/Code/OBI/core-web-app/src/components/LandingPage/content/members.ts", "TypeScript", 39, 0, 0, 0, 0, 4, 43
"/Users/tolokoban/Code/OBI/core-web-app/src/components/LandingPage/content/news.ts", "TypeScript", 45, 0, 0, 0, 0, 5, 50
"/Users/tolokoban/Code/OBI/core-web-app/src/components/LandingPage/content/our-foundations.ts", "TypeScript", 58, 0, 0, 0, 0, 7, 65
"/Users/tolokoban/Code/OBI/core-web-app/src/components/LandingPage/content/our-mission.ts", "TypeScript", 6, 0, 0, 0, 0, 2, 8
"/Users/tolokoban/Code/OBI/core-web-app/src/components/LandingPage/content/portals.ts", "TypeScript", 43, 0, 0, 0, 0, 5, 48
"/Users/tolokoban/Code/OBI/core-web-app/src/components/LandingPage/content/privacy-policy.ts", "TypeScript", 6, 0, 0, 0, 0, 2, 8
"/Users/tolokoban/Code/OBI/core-web-app/src/components/LandingPage/content/team.ts", "TypeScript", 6, 0, 0, 0, 0, 2, 8
"/Users/tolokoban/Code/OBI/core-web-app/src/components/LandingPage/content/terms-and-conditions.ts", "TypeScript", 6, 0, 0, 0, 0, 2, 8
"/Users/tolokoban/Code/OBI/core-web-app/src/components/LandingPage/content/types.ts", "TypeScript", 153, 0, 0, 0, 0, 19, 172
"/Users/tolokoban/Code/OBI/core-web-app/src/components/LandingPage/content/virtualLabs.ts", "TypeScript", 32, 0, 0, 0, 0, 5, 37
"/Users/tolokoban/Code/OBI/core-web-app/src/components/LandingPage/icons/IconArrowRight.tsx", "TypeScript JSX", 0, 12, 0, 0, 0, 1, 13
"/Users/tolokoban/Code/OBI/core-web-app/src/components/LandingPage/icons/IconBoxEmpty.tsx", "TypeScript JSX", 0, 11, 0, 0, 0, 1, 12
"/Users/tolokoban/Code/OBI/core-web-app/src/components/LandingPage/icons/IconBoxFilled.tsx", "TypeScript JSX", 0, 11, 0, 0, 0, 1, 12
"/Users/tolokoban/Code/OBI/core-web-app/src/components/LandingPage/icons/IconChevronLeft.tsx", "TypeScript JSX", 0, 12, 0, 0, 0, 1, 13
"/Users/tolokoban/Code/OBI/core-web-app/src/components/LandingPage/icons/IconChevronRight.tsx", "TypeScript JSX", 0, 12, 0, 0, 0, 1, 13
"/Users/tolokoban/Code/OBI/core-web-app/src/components/LandingPage/icons/IconClose.tsx", "TypeScript JSX", 0, 11, 0, 0, 0, 1, 12
"/Users/tolokoban/Code/OBI/core-web-app/src/components/LandingPage/icons/IconDownloadFile.tsx", "TypeScript JSX", 0, 14, 0, 0, 0, 1, 15
"/Users/tolokoban/Code/OBI/core-web-app/src/components/LandingPage/icons/IconMenu.tsx", "TypeScript JSX", 0, 8, 0, 0, 0, 1, 9
"/Users/tolokoban/Code/OBI/core-web-app/src/components/LandingPage/icons/IconPlus.tsx", "TypeScript JSX", 0, 16, 0, 0, 0, 1, 17
"/Users/tolokoban/Code/OBI/core-web-app/src/components/LandingPage/index.ts", "TypeScript", 1, 0, 0, 0, 0, 1, 2
"/Users/tolokoban/Code/OBI/core-web-app/src/components/LandingPage/layout/FooterPanel/FooterPanel.module.css", "CSS", 0, 0, 104, 0, 0, 19, 123
"/Users/tolokoban/Code/OBI/core-web-app/src/components/LandingPage/layout/FooterPanel/FooterPanel.tsx", "TypeScript JSX", 0, 72, 0, 0, 5, 7, 84
"/Users/tolokoban/Code/OBI/core-web-app/src/components/LandingPage/layout/FooterPanel/NewsLetterSubscription/NewsLetterSubscription.module.css", "CSS", 0, 0, 50, 0, 0, 9, 59
"/Users/tolokoban/Code/OBI/core-web-app/src/components/LandingPage/layout/FooterPanel/NewsLetterSubscription/NewsLetterSubscription.tsx", "TypeScript JSX", 0, 61, 0, 0, 0, 7, 68
"/Users/tolokoban/Code/OBI/core-web-app/src/components/LandingPage/layout/FooterPanel/NewsLetterSubscription/hook.ts", "TypeScript", 11, 0, 0, 0, 1, 2, 14
"/Users/tolokoban/Code/OBI/core-web-app/src/components/LandingPage/layout/FooterPanel/NewsLetterSubscription/index.ts", "TypeScript", 1, 0, 0, 0, 0, 1, 2
"/Users/tolokoban/Code/OBI/core-web-app/src/components/LandingPage/layout/FooterPanel/icons/iconBlueSky.tsx", "TypeScript JSX", 0, 31, 0, 0, 0, 1, 32
"/Users/tolokoban/Code/OBI/core-web-app/src/components/LandingPage/layout/FooterPanel/icons/iconLinkedin.tsx", "TypeScript JSX", 0, 40, 0, 0, 0, 1, 41
"/Users/tolokoban/Code/OBI/core-web-app/src/components/LandingPage/layout/FooterPanel/icons/iconTwitter.tsx", "TypeScript JSX", 0, 31, 0, 0, 0, 1, 32
"/Users/tolokoban/Code/OBI/core-web-app/src/components/LandingPage/layout/FooterPanel/index.ts", "TypeScript", 1, 0, 0, 0, 0, 1, 2
"/Users/tolokoban/Code/OBI/core-web-app/src/components/LandingPage/layout/Hero/Hero.module.css", "CSS", 0, 0, 78, 0, 0, 13, 91
"/Users/tolokoban/Code/OBI/core-web-app/src/components/LandingPage/layout/Hero/Hero.tsx", "TypeScript JSX", 0, 63, 0, 0, 1, 6, 70
"/Users/tolokoban/Code/OBI/core-web-app/src/components/LandingPage/layout/Hero/NextPanel/NextPanel.module.css", "CSS", 0, 0, 31, 0, 0, 4, 35
"/Users/tolokoban/Code/OBI/core-web-app/src/components/LandingPage/layout/Hero/NextPanel/NextPanel.tsx", "TypeScript JSX", 0, 29, 0, 0, 3, 6, 38
"/Users/tolokoban/Code/OBI/core-web-app/src/components/LandingPage/layout/Hero/NextPanel/index.ts", "TypeScript", 1, 0, 0, 0, 0, 1, 2
"/Users/tolokoban/Code/OBI/core-web-app/src/components/LandingPage/layout/Hero/index.ts", "TypeScript", 1, 0, 0, 0, 0, 1, 2
"/Users/tolokoban/Code/OBI/core-web-app/src/components/LandingPage/layout/Menu/HeaderLoginButton/HeaderLoginButton.module.css", "CSS", 0, 0, 33, 0, 0, 8, 41
"/Users/tolokoban/Code/OBI/core-web-app/src/components/LandingPage/layout/Menu/HeaderLoginButton/HeaderLoginButton.tsx", "TypeScript JSX", 0, 36, 0, 0, 5, 5, 46
"/Users/tolokoban/Code/OBI/core-web-app/src/components/LandingPage/layout/Menu/HeaderLoginButton/index.ts", "TypeScript", 1, 0, 0, 0, 0, 1, 2
"/Users/tolokoban/Code/OBI/core-web-app/src/components/LandingPage/layout/Menu/Menu.module.css", "CSS", 0, 0, 95, 0, 0, 19, 114
"/Users/tolokoban/Code/OBI/core-web-app/src/components/LandingPage/layout/Menu/Menu.tsx", "TypeScript JSX", 0, 56, 0, 0, 0, 6, 62
"/Users/tolokoban/Code/OBI/core-web-app/src/components/LandingPage/layout/Menu/PopupMenu/PopupMenu.module.css", "CSS", 0, 0, 62, 0, 0, 8, 70
"/Users/tolokoban/Code/OBI/core-web-app/src/components/LandingPage/layout/Menu/PopupMenu/PopupMenu.tsx", "TypeScript JSX", 0, 52, 0, 0, 0, 6, 58
"/Users/tolokoban/Code/OBI/core-web-app/src/components/LandingPage/layout/Menu/PopupMenu/index.ts", "TypeScript", 1, 0, 0, 0, 0, 1, 2
"/Users/tolokoban/Code/OBI/core-web-app/src/components/LandingPage/layout/Menu/index.ts", "TypeScript", 1, 0, 0, 0, 0, 1, 2
"/Users/tolokoban/Code/OBI/core-web-app/src/components/LandingPage/loris.ts", "TypeScript", 24, 0, 0, 0, 3, 8, 35
"/Users/tolokoban/Code/OBI/core-web-app/src/components/LandingPage/sections/SectionContact/Cards/Card/Card.module.css", "CSS", 0, 0, 40, 0, 0, 7, 47
"/Users/tolokoban/Code/OBI/core-web-app/src/components/LandingPage/sections/SectionContact/Cards/Card/Card.tsx", "TypeScript JSX", 0, 22, 0, 0, 0, 5, 27
"/Users/tolokoban/Code/OBI/core-web-app/src/components/LandingPage/sections/SectionContact/Cards/Card/index.ts", "TypeScript", 1, 0, 0, 0, 0, 1, 2
"/Users/tolokoban/Code/OBI/core-web-app/src/components/LandingPage/sections/SectionContact/Cards/Cards.module.css", "CSS", 0, 0, 13, 0, 0, 2, 15
"/Users/tolokoban/Code/OBI/core-web-app/src/components/LandingPage/sections/SectionContact/Cards/Cards.tsx", "TypeScript JSX", 0, 30, 0, 0, 0, 5, 35
"/Users/tolokoban/Code/OBI/core-web-app/src/components/LandingPage/sections/SectionContact/Cards/index.ts", "TypeScript", 1, 0, 0, 0, 0, 1, 2
"/Users/tolokoban/Code/OBI/core-web-app/src/components/LandingPage/sections/SectionContact/SectionContact.module.css", "CSS", 0, 0, 11, 0, 0, 2, 13
"/Users/tolokoban/Code/OBI/core-web-app/src/components/LandingPage/sections/SectionContact/SectionContact.tsx", "TypeScript JSX", 0, 25, 0, 0, 2, 5, 32
"/Users/tolokoban/Code/OBI/core-web-app/src/components/LandingPage/sections/SectionContact/index.ts", "TypeScript", 1, 0, 0, 0, 0, 1, 2
"/Users/tolokoban/Code/OBI/core-web-app/src/components/LandingPage/sections/SectionGeneric/SectionGeneric.tsx", "TypeScript JSX", 0, 12, 0, 0, 0, 5, 17
"/Users/tolokoban/Code/OBI/core-web-app/src/components/LandingPage/sections/SectionGeneric/index.ts", "TypeScript", 1, 0, 0, 0, 0, 1, 2
"/Users/tolokoban/Code/OBI/core-web-app/src/components/LandingPage/sections/SectionNews/Card/Card.module.css", "CSS", 0, 0, 4, 0, 0, 1, 5
"/Users/tolokoban/Code/OBI/core-web-app/src/components/LandingPage/sections/SectionNews/Card/Card.tsx", "TypeScript JSX", 0, 23, 0, 0, 0, 6, 29
"/Users/tolokoban/Code/OBI/core-web-app/src/components/LandingPage/sections/SectionNews/Card/index.ts", "TypeScript", 1, 0, 0, 0, 0, 1, 2
"/Users/tolokoban/Code/OBI/core-web-app/src/components/LandingPage/sections/SectionNews/CategoryButton/CategoryButton.module.css", "CSS", 0, 0, 15, 0, 0, 2, 17
"/Users/tolokoban/Code/OBI/core-web-app/src/components/LandingPage/sections/SectionNews/CategoryButton/CategoryButton.tsx", "TypeScript JSX", 0, 25, 0, 0, 0, 5, 30
"/Users/tolokoban/Code/OBI/core-web-app/src/components/LandingPage/sections/SectionNews/CategoryButton/index.ts", "TypeScript", 1, 0, 0, 0, 0, 1, 2
"/Users/tolokoban/Code/OBI/core-web-app/src/components/LandingPage/sections/SectionNews/SectionNews.module.css", "CSS", 0, 0, 2, 0, 0, 1, 3
"/Users/tolokoban/Code/OBI/core-web-app/src/components/LandingPage/sections/SectionNews/SectionNews.tsx", "TypeScript JSX", 0, 62, 0, 0, 0, 9, 71
"/Users/tolokoban/Code/OBI/core-web-app/src/components/LandingPage/sections/SectionNews/index.ts", "TypeScript", 1, 0, 0, 0, 0, 1, 2
"/Users/tolokoban/Code/OBI/core-web-app/src/components/LandingPage/sections/sections.ts", "TypeScript", 14, 0, 0, 0, 0, 3, 17
"/Users/tolokoban/Code/OBI/core-web-app/src/components/LandingPage/styles.module.css", "CSS", 0, 0, 57, 0, 0, 10, 67
"/Users/tolokoban/Code/OBI/core-web-app/src/components/LandingPage/styles.ts", "TypeScript", 8, 0, 0, 0, 0, 8, 16
"/Users/tolokoban/Code/OBI/core-web-app/src/components/LandingPage/utils.ts", "TypeScript", 25, 0, 0, 0, 4, 6, 35
"/Users/tolokoban/Code/OBI/core-web-app/src/components/LandingPage/widgets/CompanyMembers/CompanyMembers.module.css", "CSS", 0, 0, 15, 0, 0, 2, 17
"/Users/tolokoban/Code/OBI/core-web-app/src/components/LandingPage/widgets/CompanyMembers/CompanyMembers.tsx", "TypeScript JSX", 0, 30, 0, 0, 1, 6, 37
"/Users/tolokoban/Code/OBI/core-web-app/src/components/LandingPage/widgets/CompanyMembers/TeamMember/TeamMember.module.css", "CSS", 0, 0, 50, 0, 0, 8, 58
"/Users/tolokoban/Code/OBI/core-web-app/src/components/LandingPage/widgets/CompanyMembers/TeamMember/TeamMember.tsx", "TypeScript JSX", 0, 39, 0, 0, 1, 7, 47
"/Users/tolokoban/Code/OBI/core-web-app/src/components/LandingPage/widgets/CompanyMembers/TeamMember/index.ts", "TypeScript", 1, 0, 0, 0, 0, 1, 2
"/Users/tolokoban/Code/OBI/core-web-app/src/components/LandingPage/widgets/CompanyMembers/hook.ts", "TypeScript", 63, 0, 0, 0, 0, 7, 70
"/Users/tolokoban/Code/OBI/core-web-app/src/components/LandingPage/widgets/CompanyMembers/index.ts", "TypeScript", 1, 0, 0, 0, 0, 1, 2
"/Users/tolokoban/Code/OBI/core-web-app/src/components/LandingPage/widgets/CompanyMembers/types.ts", "TypeScript", 1, 0, 0, 0, 0, 1, 2
"/Users/tolokoban/Code/OBI/core-web-app/src/components/LandingPage/widgets/ContributorsPanel/ContributorsList/ContributorsList.module.css", "CSS", 0, 0, 48, 0, 0, 8, 56
"/Users/tolokoban/Code/OBI/core-web-app/src/components/LandingPage/widgets/ContributorsPanel/ContributorsList/ContributorsList.tsx", "TypeScript JSX", 0, 75, 0, 0, 0, 8, 83
"/Users/tolokoban/Code/OBI/core-web-app/src/components/LandingPage/widgets/ContributorsPanel/ContributorsList/index.ts", "TypeScript", 1, 0, 0, 0, 0, 1, 2
"/Users/tolokoban/Code/OBI/core-web-app/src/components/LandingPage/widgets/ContributorsPanel/ContributorsNavigation/ContributorsNavigation.module.css", "CSS", 0, 0, 124, 0, 0, 20, 144
"/Users/tolokoban/Code/OBI/core-web-app/src/components/LandingPage/widgets/ContributorsPanel/ContributorsNavigation/ContributorsNavigation.tsx", "TypeScript JSX", 0, 113, 0, 0, 1, 10, 124
"/Users/tolokoban/Code/OBI/core-web-app/src/components/LandingPage/widgets/ContributorsPanel/ContributorsNavigation/index.ts", "TypeScript", 1, 0, 0, 0, 0, 1, 2
"/Users/tolokoban/Code/OBI/core-web-app/src/components/LandingPage/widgets/ContributorsPanel/ContributorsPanel.module.css", "CSS", 0, 0, 0, 0, 0, 1, 1
"/Users/tolokoban/Code/OBI/core-web-app/src/components/LandingPage/widgets/ContributorsPanel/ContributorsPanel.tsx", "TypeScript JSX", 0, 16, 0, 0, 0, 4, 20
"/Users/tolokoban/Code/OBI/core-web-app/src/components/LandingPage/widgets/ContributorsPanel/data.ts", "TypeScript", 22, 0, 0, 0, 0, 5, 27
"/Users/tolokoban/Code/OBI/core-web-app/src/components/LandingPage/widgets/ContributorsPanel/index.ts", "TypeScript", 1, 0, 0, 0, 0, 1, 2
"/Users/tolokoban/Code/OBI/core-web-app/src/components/LandingPage/widgets/Email/Email.module.css", "CSS", 0, 0, 2, 0, 0, 1, 3
"/Users/tolokoban/Code/OBI/core-web-app/src/components/LandingPage/widgets/Email/Email.tsx", "TypeScript JSX", 0, 18, 0, 0, 0, 6, 24
"/Users/tolokoban/Code/OBI/core-web-app/src/components/LandingPage/widgets/Email/index.ts", "TypeScript", 1, 0, 0, 0, 0, 1, 2
"/Users/tolokoban/Code/OBI/core-web-app/src/components/LandingPage/widgets/FromCellToBrain/FromCellToBrain.module.css", "CSS", 0, 0, 42, 0, 0, 7, 49
"/Users/tolokoban/Code/OBI/core-web-app/src/components/LandingPage/widgets/FromCellToBrain/FromCellToBrain.tsx", "TypeScript JSX", 0, 34, 0, 0, 0, 6, 40
"/Users/tolokoban/Code/OBI/core-web-app/src/components/LandingPage/widgets/FromCellToBrain/hooks.ts", "TypeScript", 35, 0, 0, 0, 0, 3, 38
"/Users/tolokoban/Code/OBI/core-web-app/src/components/LandingPage/widgets/FromCellToBrain/index.ts", "TypeScript", 1, 0, 0, 0, 0, 1, 2
"/Users/tolokoban/Code/OBI/core-web-app/src/components/LandingPage/widgets/FromCellToBrain/types.ts", "TypeScript", 34, 0, 0, 0, 0, 5, 39
"/Users/tolokoban/Code/OBI/core-web-app/src/components/LandingPage/widgets/Hero/Hero.module.css", "CSS", 0, 0, 32, 0, 0, 5, 37
"/Users/tolokoban/Code/OBI/core-web-app/src/components/LandingPage/widgets/Hero/Hero.tsx", "TypeScript JSX", 0, 49, 0, 0, 0, 8, 57
"/Users/tolokoban/Code/OBI/core-web-app/src/components/LandingPage/widgets/Hero/hooks.ts", "TypeScript", 49, 0, 0, 0, 0, 5, 54
"/Users/tolokoban/Code/OBI/core-web-app/src/components/LandingPage/widgets/Hero/index.ts", "TypeScript", 1, 0, 0, 0, 0, 1, 2
"/Users/tolokoban/Code/OBI/core-web-app/src/components/LandingPage/widgets/MissionStatement/MissionStatement.module.css", "CSS", 0, 0, 63, 0, 0, 8, 71
"/Users/tolokoban/Code/OBI/core-web-app/src/components/LandingPage/widgets/MissionStatement/MissionStatement.tsx", "TypeScript JSX", 0, 40, 0, 0, 1, 6, 47
"/Users/tolokoban/Code/OBI/core-web-app/src/components/LandingPage/widgets/MissionStatement/hooks.ts", "TypeScript", 38, 0, 0, 0, 0, 5, 43
"/Users/tolokoban/Code/OBI/core-web-app/src/components/LandingPage/widgets/MissionStatement/index.ts", "TypeScript", 1, 0, 0, 0, 0, 1, 2
"/Users/tolokoban/Code/OBI/core-web-app/src/components/LandingPage/widgets/News/News.module.css", "CSS", 0, 0, 46, 0, 0, 7, 53
"/Users/tolokoban/Code/OBI/core-web-app/src/components/LandingPage/widgets/News/News.tsx", "TypeScript JSX", 0, 92, 0, 0, 2, 10, 104
"/Users/tolokoban/Code/OBI/core-web-app/src/components/LandingPage/widgets/News/NewsCard/NewsCard.module.css", "CSS", 0, 0, 65, 0, 0, 10, 75
"/Users/tolokoban/Code/OBI/core-web-app/src/components/LandingPage/widgets/News/NewsCard/NewsCard.tsx", "TypeScript JSX", 0, 33, 0, 0, 0, 6, 39
"/Users/tolokoban/Code/OBI/core-web-app/src/components/LandingPage/widgets/News/NewsCard/index.ts", "TypeScript", 1, 0, 0, 0, 0, 1, 2
"/Users/tolokoban/Code/OBI/core-web-app/src/components/LandingPage/widgets/News/index.ts", "TypeScript", 1, 0, 0, 0, 0, 1, 2
"/Users/tolokoban/Code/OBI/core-web-app/src/components/LandingPage/widgets/OurFoundations/OurFoundations.module.css", "CSS", 0, 0, 119, 0, 1, 19, 139
"/Users/tolokoban/Code/OBI/core-web-app/src/components/LandingPage/widgets/OurFoundations/OurFoundations.tsx", "TypeScript JSX", 0, 46, 0, 0, 0, 6, 52
"/Users/tolokoban/Code/OBI/core-web-app/src/components/LandingPage/widgets/OurFoundations/ToolButton/ToolButton.module.css", "CSS", 0, 0, 19, 0, 0, 3, 22
"/Users/tolokoban/Code/OBI/core-web-app/src/components/LandingPage/widgets/OurFoundations/ToolButton/ToolButton.tsx", "TypeScript JSX", 0, 22, 0, 0, 5, 5, 32
"/Users/tolokoban/Code/OBI/core-web-app/src/components/LandingPage/widgets/OurFoundations/ToolButton/index.ts", "TypeScript", 1, 0, 0, 0, 0, 1, 2
"/Users/tolokoban/Code/OBI/core-web-app/src/components/LandingPage/widgets/OurFoundations/index.ts", "TypeScript", 1, 0, 0, 0, 0, 1, 2
"/Users/tolokoban/Code/OBI/core-web-app/src/components/LandingPage/widgets/PortalsPanel/PortalsPanel.module.css", "CSS", 0, 0, 11, 0, 0, 1, 12
"/Users/tolokoban/Code/OBI/core-web-app/src/components/LandingPage/widgets/PortalsPanel/PortalsPanel.tsx", "TypeScript JSX", 0, 26, 0, 0, 0, 6, 32
"/Users/tolokoban/Code/OBI/core-web-app/src/components/LandingPage/widgets/PortalsPanel/card/PortalCard.module.css", "CSS", 0, 0, 95, 0, 0, 15, 110
"/Users/tolokoban/Code/OBI/core-web-app/src/components/LandingPage/widgets/PortalsPanel/card/PortalCard.tsx", "TypeScript JSX", 0, 30, 0, 0, 0, 6, 36
"/Users/tolokoban/Code/OBI/core-web-app/src/components/LandingPage/widgets/PortalsPanel/index.ts", "TypeScript", 1, 0, 0, 0, 0, 1, 2
"/Users/tolokoban/Code/OBI/core-web-app/src/components/LandingPage/widgets/VirtualLabsPanel/VirtualLabsPanel.module.css", "CSS", 0, 0, 14, 0, 0, 2, 16
"/Users/tolokoban/Code/OBI/core-web-app/src/components/LandingPage/widgets/VirtualLabsPanel/VirtualLabsPanel.tsx", "TypeScript JSX", 0, 24, 0, 0, 2, 5, 31
"/Users/tolokoban/Code/OBI/core-web-app/src/components/LandingPage/widgets/VirtualLabsPanel/card/card.module.css", "CSS", 0, 0, 76, 0, 0, 9, 85
"/Users/tolokoban/Code/OBI/core-web-app/src/components/LandingPage/widgets/VirtualLabsPanel/card/card.tsx", "TypeScript JSX", 0, 22, 0, 0, 3, 3, 28
"/Users/tolokoban/Code/OBI/core-web-app/src/components/LandingPage/widgets/VirtualLabsPanel/card/index.ts", "TypeScript", 1, 0, 0, 0, 0, 1, 2
"/Users/tolokoban/Code/OBI/core-web-app/src/components/LandingPage/widgets/VirtualLabsPanel/index.ts", "TypeScript", 1, 0, 0, 0, 0, 1, 2
"/Users/tolokoban/Code/OBI/core-web-app/src/components/LandingPage/widgets/index.ts", "TypeScript", 6, 0, 0, 0, 0, 1, 7
"Total", "-", 1044, 2097, 1832, 3, 58, 823, 5857